11111111111111111111
1E000C00000000000001
10111010001000000001
101010100C1000C00001
10111010001000000001
1010101110100C00P001
10000C00000000000001
11111111111111111111