1111111111111111111111111111111111
1E00000A0000000C00000C000000A00001
1010010100100000101001000000010101
1010010010101010001001000000010101
1PC000000C00C0000A0000A000000000C1
1111111111111111111111111111111111